###############################S#############################
#       #           #       #           #               #   #
####### # ##### ### # ### # ##### # ### ### # ######### ### #
#     #   #   #   #   # # #     # # # #   # # #   #   #   # #
# ### # ### # ####### # # ##### # # # ### # # # # # ##### # #
# #   #   # #       #   # # #   # # #     # # # # #     # # #
# # ####### ####### ##### # # ##### # ####### # # ### ### # #
# #       #     # #       # #       # #       # #   #   # # #
# ####### # ### # ######### ######### # ### ### ### # # # # #
#   #   # # #   #               #   # # #   #   # # # # #   #
### # ### # # ##### ######### ### # # # # # # ### # # # ### #
#   # #   # #     #     #   #   # # # # # # # #   # # #   # #
# ### # ### ##### ##### ### ### # # # # # # # # ### ##### # #
#   #   #       # #         # #   #   # # # # # #   #   #   #
### # ########### ######### # ######### # ### # # ### # # ###
#   # #         # #   #   # #   #       #     # # #   # #   #
# ### # ####### # # # # ### # # # ############# # # ### ### #
# # # # #     # #   # #   # # # #   #   #       #   # #   # #
# # # # # ### # ##### # # # # # ### # # ####### ##### ### ###
# # #   #   #   #     # # # # #   # # #         #       #   #
# # # ##### ##### ##### # # # ### # # ######### ####### ### #
# # # #   #       # #   #     #   # # #       #     #   #   #
# # # # # ######### # ######### ### # # ### ####### # # # # #
# #   # # #   #   # #     #   # #     #   #       #   # # # #
# ##### # # # # # # # ##### # # ############# # ####### # ###
#       #   #   # #   #     # #     #       # # #     # #   #
# ############### ##### ##### ##### # ##### # ### # # # ### #
#   # #         #       #   #   # #   #     #   # # # #   # #
### # # ####### ######### # ### # ##### ##### # # # ### ### #
# # #   #     # #       # # #   #       #   # #   #     #   #
# # # ### ### # # ### ### # # ##### ##### ### ########### ###
# # # #   #   #   # #     # #     # #       #         #   # #
# # # # ### ### ### ####### ##### # ##### # ### ####### # # #
# # # #   # #     #   #       #   #     # # #   #       # # #
# # # ### # ##### ### # ##### # ####### ### # ### ### ##### #
#   #   # #     #     # # #   #     #   #   #   # #   #     #
# ####### ##### ####### # # ####### # ### ### ### # ### #####
#     #   #   #   #     # # #       # #     # #   # # # #   #
##### # ### # ### # ##### # # ####### ##### # # ### # # # ###
# #     #   # #     #       #   #   # #   # # #   #   # #   #
# # ##### ### ################# # ### # # # # ### ### # ### #
#   # #   #   #           #     #       # #   # #   # # #   #
# ### # ### ### ######### # ############# # ### ### # # # ###
#     # # #     #     #   #   #         # #       # # # #   #
##### # # # ##### ### # ##### # ####### # ### ##### ### # # #
# #   # #   #     #   #     # # #     # #   # #   # #   # # #
# # ### ##### ##### ####### # # # ### # ### ### # # # ### # #
#   # #       #   # #         #   #   # #   #   # # #   # # #
# ### ######### # # ######### ##### ### # ### ### # ### # # #
# #             # #       #   #       # #   #   # #   # # # #
# # # ########### ####### ##### ####### ### # # # ### # ### #
# # #     #   #   #   #   #   # #   #   #   # # #   # #   # #
# ### ### ### # ##### # ### # # # ### ### ##### ### # ### # #
#   # # #   # # #   # #     #   #   # #         #   #   # # #
### # # ### # # # # # ############# # ########### ### ### # #
# # #   #   #   # # #     #         #     #         #   # # #
# # ##### ### ### # # ### ##### ### ##### ######### ### # # #
# #   #   #   #   # #   # #     # # # #   #     #       #   #
# ### # ### ##### # ### # # ##### # # # ### ### ########### #
#       #         #     #   #         #       #             #
###############################E#############################