###########S#########
#             # #   #
# ##### ##### # # # #
# #     #   # #   # #
# ####### # # ##### #
#         # #       #
# ######### ####### #
#   #   #   #   #   #
##### # # ### ### ###
#     #   #         #
# ######### #########
#       #   #       #
# ##### ##### #######
#   #   #     #     #
### # ### ####### # #
# # #   # #     # # #
# # ### # # ### # # #
# #   # # #   #   # #
# ### # # ### ##### #
#     #       #     #
###########E#########