####################
#########E##########
#S####### ##########
# #####        #####
# ############  ####
#      ######## ####
# #### ######## ####
# #### ######## ####
# #                #
# #### ########### #
##############     #