#################################S###############################
#   #       #     #         #         #               #   #     #
# # # ### ### ### # ### # ### # ##### # ############# ### # # ###
# # # # # #   # #     # # #   # #     # #       #   #   #   #   #
# # # # # # ### ##### # ### ### # ##### # ##### ### ### ### ### #
# # #   # #     #   # #     # # #       # #   #   #   #   #   # #
### # ### ##### # # # ####### # ####### # # # ### # # ### # ### #
#   # #   #     # # # #   #   #     #   #   # #   # #   # # #   #
# # # # ### ##### # # # # # ####### ####### ### ####### # ### # #
# # # #   #     # # #   # #       #         #   #     # #     # #
# ### ### ### ### # ##### ### ### ########### # # ### # ####### #
# #     #     #   #   # #   #   #           # # # # # #         #
# # ####### ### ##### # ### ### # ######### # # # # # # ##### ###
#   #     # #   # #   #   #   # #     #   # # # #   # # #   #   #
# ### ### ### ### # ##### ### # ##### ### # # ##### # ### # ### #
# #   #       #   #     #   # #     # #   # #     # #     # #   #
# # ########### # ##### # # # ##### # # # # ##### # ####### ### #
# #       #     #   #   # # #     # # # # # # #   #   #   #   # #
# ####### # ##### ### ### ####### # # # ### # # ##### # ##### # #
# #     # # #   #       #       # # # #     # #       #     # # #
# # ##### ### # # ##### ####### # ### # ##### ########### ### # #
# #     #     # # #   #   #   # # #   # #       #         #   # #
# # ### ####### # # # ### # # # # # ### # ##### # # ##### # #####
# # #   #   #   # # #   #   # # #   # #   # #   # # #     #     #
# ### # ### # ##### ### ##### # ##### ##### # ##### ##### ##### #
#     # #   # #     # # #   # #     #   #     #   # #   #     # #
####### # ### # ##### # ### # # ### # # # ##### # # # # ####### #
#   #   #   #         #   #   #   # # # #     # # # # #   #     #
# # # ### # ############# # ##### ### # ##### # # # # ### # ### #
# #   #   #   #   #     # #     #   # #   #     #   #   #   #   #
# ####### # ### # # ### # ##### ### # # ### ####### ### ##### ###
#       # # #   #   # #   #   #   #   #       #   #   #   # #   #
####### ### # ####### # ### # ### ### ######### # ### ### # ### #
#   #       #     # #   #   # #     # #       # # #     # # #   #
### ####### ##### # # ### ### ##### # # ##### # # ####### # # ###
# #       # #     #     # # #   #   # # #     # # #   #   #   # #
# ####### ### ##### ##### # ### # ##### # ##### # # # # ##### # #
#       #   #   #     #       # #     # #       #   # # #   #   #
# # ####### # # ####### ####### ##### # # ########### # # # #####
# #   #   # # #       # #     #   #   # # #   #       # # #     #
# ### # # # # ####### # # ### ### # ### ### # ### ##### # ##### #
# # #   #   #   # #   # # #       # #     # #   #       # # #   #
# # ########### # # ### # ######### # ### # ### ####### # # # # #
# #           #   # #   #   #     # #   #     # #       #   # # #
# ### ####### ##### # ##### # ### # ### ####### ########### # ###
#   # #   #   #   #     #   # #   # # #   # #   #   #   #   #   #
### # # # # ### # ### ### ### # ### # ### # # ### # # # # ##### #
#   # # #   #   #   # #   #   #   # #       #     #   #   #   # #
# ### # ##### ##### ### ##### ### # ### ######### ####### # # # #
#   # #   #   #       # #   #   # #   # #       # #     # # # # #
### # ### ### ####### # # # # # # ### ### ##### # # ### ### # # #
#   # #     # #     #   # # # # #   #     # #   # # #   #   #   #
# ### ##### # # ### ##### # ### # ######### # ### # # ### ##### #
# #     # # #     # #     # #   # #         # #   # # #       # #
# # ### # # ##### # # ##### # ### # ####### # ##### # ##### # ###
# # #   # #     # #   #     # #   #   # #   # #     #     # #   #
# ### ### ##### ##### # ##### ### ### # # ### # ######### # ### #
#     # #     #     # # #   #   # #   # # #   # #   #   # # #   #
####### # # # ##### ### # # # # ### ### # # ### # ### # # # # # #
#         # #   #   #   # # # #   #     #   #   #     #   # # # #
# ######### ##### ### ### ### ### ##### ##### # ### ######### ###
#   #       #   #     #     # # # #     #     #   # #       #   #
### # ####### # ####### ### # # # # ############# # ##### # ### #
#   #         #           #     #                 #       #     #
#################################E###############################